Level:1
11111111111111100111111111111111
11000000000000000000000000000011
11000000000000000000000000000011
11000000M0000000000000000M000011
11000000000001111110000000000011
11000000000000000000000000000011
11000000000000000000000000000011
11000000000000000000000000000011
11000000000000000000000000000011
11000000001111100111110000000011
11000000000000000000000000000011
11000000000000000000000000000011
11000000000000000000000000000011
11000000000000000000000000000011
11000001111111111111111110000011
11000000000000000000000000000011
11000000000000000000000000000011
11000000000000000000000000000011
11000000000000000000000000000011
11001111111001111110011111110011
11000000000000000000000000000011
11000000000000000000000000000011
11000000000000000000000000000011
11000000000000000000000000000011
11111111111111111111111111111111
END
Level:2
22222222222222200222222222222222
22000000000000000000000000000022
22000000000000000000000000000022
22000000000000000000000000000022
22000000000001111110000000000022
22000000000000000000000000000022
22000000000000000000000000000022
22000000000000000000000000000022
22000000000000000000000000000022
22000000001111100111110000000022
22000000000000000000000000000022
22000000000000000000000000000022
22000000000000000000000000000022
22000000000000000000000000000022
22000001111111111111111110000022
22000000000000000000000000000022
22000000000000000000000000000022
22000000000000000000000000000022
22000000000000000000000000000022
22001111111001111110011111110022
22000000000000000000000000000022
22000000000000000000000000000022
22000000000000000000000000000022
22000000000000000000000000000022
22222222222222222222222222222222
END
Level:3
33333333333333300333333333333333
33000000000000000000000000000033
33000000000000000000000000000033
33000000000000000000000000000033
33000000000001111110000000000033
33000000000000000000000000000033
33000000000000000000000000000033
33000000000000000000000000000033
33000000000000000000000000000033
33000000001111100111110000000033
33000000000000000000000000000033
33000000000000000000000000000033
33000000000000000000000000000033
33000000000000000000000000000033
33000001111111111111111110000033
33000000000000000000000000000033
33000000000000000000000000000033
33000000000000000000000000000033
33000000000000000000000000000033
33001111111001111110011111110033
33000000000000000000000000000033
33000000000000000000000000000033
33000000000000000000000000000033
33000000000000000000000000000033
33333333333333333333333333333333
END