Level:1
11111111111111100111111111111111
11000000000000000000000000000011
11000000000000000000000000000011
11000000Z0000000000000000Z000011
11000000000001111110000000000011
11000000000000000000000000000011
11000000000000000000000000000011
11000000000000000000000000000011
11000000000000000000000000000011
11000000001111100111110000000011
11000000000000000000000000000011
11000000000000000000000000000011
11000000000000000000000000000011
11000000000000000000000000000011
11000001111111111111111110000011
11000000000000000000000000000011
11000000000000000000000000000011
11000000000000000000000000000011
11000000000000000000000000000011
11000111110000111110001111100011
11000000000000000000000000000011
11000000000000000000000000000011
11000000000000000000000000000011
11000000000000000000000000000011
11111111111111111111111111111111
END
Level:2
22222222222222200222222222222222
22000000000000000000000000000022
2200000Z000000000000000Z00000022
22000000000000000000000000000022
22000022222000000000222220000022
22000000000000000000000000000022
22000000000000000000000000000022
220000000000000M0000000000000022
22000000000000000000000000000022
22000000002222222222220000000022
22000000000000000000000000000022
22000000000000000000000M00000022
22000000000000000000000000000022
22000000000000000000000000000022
22000000000000000002222220000022
22000000000000000000000000000022
22000000000000000000000000000022
22000000000000000000000000000022
22000000000000000000000000000022
22002222222002222220000000000022
22000000000000000000000000000022
22000000000000000000000000000022
22000000000000000000000000000022
22000000000000000000000000000022
22222222222222222222222222222222
END
Level:3
33333300000333300333300000333333
33000000000000000000000000000033
33000000000000000000000000000033
330000000M0000000000000000000033
33000000000000000000000000000033
33000000000000000000000000000033
33000000000000000000000000000033
330000000000M0000000M00000000033
33000000000000000000000000000033
33000000003333300333330000000033
33000000000000000000000000000033
3300000000000000000000000M000033
33000000000000000000000000000033
33000000000000000000000000000033
33000033333300000003333333000033
33000000000000000000000000000033
33000000000000000000000000000033
33000000000000000000000000000033
33000000000000000000000000000033
33000000000003333330000000000033
33000000000000000000000000000033
33000000000000000000000000000033
33000000000000000000000000000033
33000000000000000000000000000033
33333300000333333333300000333333
END